11111
1E011
1C001
10P11
1e001
11111