11111
1E011
100P1
10011
1C001
11111