11111
1E011
101P1
10011
1C001
11111