11111
1E011
100P1
10311
1C001
11111