11111
1EP11
1CH01
10011
1e001
11111