1111111
1000e01
1000001
1000001
100P001
1111111