1111111
1000001
100C001
10E0001
100P001
1111111