111111111111111
100e00C00000001
101100001000001
10000P000eE0001
111000e00000001
111111111111111