111111111111111111111
110000000000C00000001
1P1000000001011000001
11Е000000000000000001
111000000000100000001
111000001010100100001
111111000010100001001
111111111111111111111
111111111111111111111
