1111111111111
100E000000001
1P000C1111001
1000110000001
1111111111111