111111111111111
10000C000000001
101100001000001
10000P000000001
11100000E000001
111111111111111